股票代码,板块名称,当前强度_0930,当前涨幅_0930,净额_0930,成交额_0930,主力买_0930,主力卖_0930,量比_0930,流通市值_0930,300w大单净额_0930,当前强度_1500,当前涨幅_1500,净额_1500,成交额_1500,主力买_1500,主力卖_1500,量比_1500,流通市值_1500,300w大单净额_1500
801001,芯片,-12,-0.128,-17734246,601708536,38726383,-56460629,1.324,7544174923955,0,-907,-1.473,-2618250976,109970617807,8287511426,-10905762402,0.874,7452034095196,-404423000
801004,锂电池,2,0.047,12143898,584681642,85924519,-73780621,2.525,6374127227987,-7114800,-95,-0.925,-690234168,69384041218,4602700011,-5292934179,0.912,6306578332322,23635300
801008,高送转,-38,-0.386,0,40141519,0,0,2.641,998147216100,0,-89,-0.891,859734,8309996283,5598328,-4738594,0.916,991918732389,0
801009,充电桩,23,0.328,482963,176279597,10836514,-10353551,1.928,1283257009216,0,473,-0.268,22605149,19228276161,1432314563,-1409709414,0.971,1274208869760,43064800
801012,钢铁,-30,-0.301,-8379510,88036554,22435302,-30814812,8.137,772088321794,0,603,1.035,-189777316,12317583431,3187104683,-3376881999,3.194,786382096128,-46017800
801016,稀土永磁,5,0.055,139666,66190435,12670600,-12530934,2.426,824208031030,0,-81,-0.818,-76709454,9268456162,1281920312,-1358629766,1.17,818884238286,11297300
801019,物流,1,0.011,-890994,129844856,1601452,-2492446,3.917,1368119085264,0,-39,-0.392,-85086012,14517675599,898618220,-983704232,1.14,1365148767660,63941000
801022,换电站,53,0.531,659956,128839453,1002750,-342794,5.185,521450592782,0,-10,-0.11,-35083799,7088092372,124809793,-159893592,1.339,513392955746,-16033300
801027,银行,6,0.068,-1851560,53968183,16589282,-18440842,1.468,6755550917497,-3780000,79,0.793,643572829,14984362565,6335692766,-5692119937,1.446,6818367775429,678000000
801031,文化传媒,-29,-0.297,3650065,219778287,28805039,-25154974,1.91,1198266583368,3777970,-200,-1.322,-647535861,30448457956,3245711422,-3893247283,0.961,1188005375584,-32026400
801032,深圳国资改革,-66,-0.666,0,44336000,0,0,5.156,104332196936,0,-83,-0.83,-4252054,2242624292,7554290,-11806344,1.139,104149708037,0
801033,国企改革,-19,-0.172,3750263,1056976168,48968011,-45217748,3.369,7433654534080,-460891,-55,-0.538,-613448362,95206659851,2086985868,-2700434230,1.164,7416761568696,-47546100
801035,酿酒,-8,0.067,8746737,196185688,59230693,-50483956,3.193,4791838065664,0,-2,0.123,496659434,28705810547,8314639324,-7817979890,0.954,4813523415402,253040000
801039,机场航空,-17,-0.171,-3107100,18382352,2692897,-5799997,1.843,647484005396,0,8,0.084,-10050378,3488799721,899463880,-909514258,1.155,649581402318,-46434600
801040,造纸,-9,-0.097,-3461517,12131785,376216,-3837733,2.959,174104331332,0,-89,-0.898,-35540662,1704423478,196573831,-232114493,1.039,173256926794,0
801044,土地流转,-69,-0.694,-353158,71107182,1763088,-2116246,3.211,354819783682,0,-81,-0.816,-20991877,6109828065,103675520,-124667397,1.094,354394148349,0
801045,医药,-1,-0.019,4168875,242500945,27491486,-23322611,1.418,6122017422525,3042360,-56,-0.563,-575424884,52196280854,4832026295,-5407451179,0.962,6104516758820,-115194000
801046,医疗器械,-61,-0.014,206377,70200231,6629471,-6423094,1.248,1787194474626,0,-56,-0.567,115524635,15517950814,1795059659,-1679535024,0.994,1782919036567,194291000
801047,钠电池,6,0.064,1090000,146758791,1786000,-696000,1.041,2007051608574,0,-92,-0.925,-76935679,17972745356,204061827,-280997506,0.948,1984870882460,17528000
801048,黄金,-32,-0.33,-6119865,55797059,9276322,-15396187,1.903,847901828055,-6570000,-77,-0.774,-59998637,6930604865,933768610,-993767247,0.952,841709985496,-23931500
801049,租售同权,-178,-1.786,-1430415,59203519,0,-1430415,5.231,458267481856,0,-93,0.162,-8282614,5143167434,51821385,-60103999,1.322,461106056125,0
801050,彩票概念,-8,-0.082,-437782,64633579,0,-437782,1.834,136783742340,0,-88,-0.883,-25618338,6411590701,16760958,-42379296,0.883,136418472136,0
801052,环保,451,-0.233,-12816569,490109704,99164581,-111981150,6.433,1748696933952,0,511,-0.771,-624074927,29745141364,1894371192,-2518446119,1.211,1740952218699,-25127200
801053,零售,-102,-0.421,5527447,435237021,40566003,-35038556,3.032,2758559039301,12821500,101,-0.984,-648336198,44926364876,1422685369,-2071021567,0.96,2747172564209,-61990000
801057,石油石化,8,0.087,-57640,22778991,1562001,-1619641,0.785,2744004477941,0,-22,-0.223,-102650188,7416274330,932487507,-1035137695,1.12,2737750668240,4352090
801062,军工,441,0.162,-21295761,588101719,200761046,-222056807,1.827,4548708006464,17692000,1455,-0.199,123294914,74275097987,10368655781,-10245360867,1.147,4528231055104,136271000
801067,面板,-130,-0.102,244112,199965515,48067171,-47823059,1.331,2066949807328,8089140,-432,-1.324,-680268564,29970276340,2881275299,-3561543863,0.849,2043260973370,-208480000
801070,光伏,-12,-0.1,-19726236,537513827,16748554,-36474790,2.452,6913120511744,0,-82,-0.719,-1150068214,78166555173,6423103944,-7573172158,1.081,6868764982464,-96633100
801071,保险,0,-0.006,2832897,31430668,12220172,-9387275,1.049,1763475611877,-6133490,23,0.231,304531201,8589099620,3034031706,-2729500505,1.399,1781391493222,150717000
801074,核电,7,0.071,1978160,38840563,2316819,-338659,2.099,838313577557,0,0,0.156,26527596,8248722864,789861987,-763334391,1.448,841219696589,-25537000
801075,自主可控,12,0.124,-1361644,36366675,1516919,-2878563,1.103,367169126961,0,-100,-1.0,-133667510,6864917999,398076044,-531743554,0.874,363090927680,-20638000
801076,乡村振兴,-41,-0.416,-5567502,150922396,7876598,-13444100,4.672,858544565707,0,-167,-0.967,-202789226,12726280247,471065127,-673854353,1.084,853631025041,-13040000
801080,煤炭,-9,-0.092,-1127852,62843086,453898,-1581750,5.73,1456017281160,0,-6,-0.069,-37802021,6675153209,838894574,-876696595,1.231,1448470229336,-36035000
801081,证券,-22,-0.221,42767668,382815518,241480070,-198712402,5.989,2469573749970,-18317000,-607,-1.078,-2123961627,27907975531,9845498459,-11969460086,1.339,2447053805033,-817695000
801082,ST摘帽,-31,-0.219,16854105,511530373,68305899,-51451794,5.449,1694844532352,0,-143,-0.541,-421894950,37874002002,2261496888,-2683391838,1.214,1697977462742,-5809030
801085,人工智能,-80,-0.206,-25600217,1263948923,100232263,-125832480,1.998,7934903116064,6185260,141,-1.434,-2937500447,163234744093,9756625852,-12694126299,0.931,7851379071776,-489083000
801086,玻璃,-11,-0.111,-853717,10303344,0,-853717,0.943,324300136857,0,-69,-0.698,-111553525,2332290213,199928411,-311481936,0.887,322334772382,-23417100
801087,风电,0,-0.007,-7080172,95877615,8114057,-15194229,1.204,2312988950848,0,-18,-0.065,32106204,23100560434,1964287063,-1932180859,1.162,2308340855744,22302700
801088,有色金属,11,0.113,-1296627,151787675,8347683,-9644310,1.764,2572222163668,0,-46,-0.46,-353829898,24026556870,2342841726,-2696671624,1.048,2552622572397,-146600000
801092,蓄电池,13,0.135,0,8454029,0,0,1.774,110266143091,0,-41,-0.417,1872516,1409158254,1872516,0,1.207,109927198197,0
801093,天然气,-10,-0.106,1232916,50314600,3242891,-2009975,1.727,2625036976320,0,-51,-0.397,-160592295,9392573231,754438880,-915031175,0.994,2616151059155,-58478600
801095,游戏,-19,-0.193,-7598455,111726238,7785646,-15384101,1.267,688551776605,0,-125,-1.259,-913633819,19678737017,2551874624,-3465508443,0.807,681619591102,-127829000
801096,钽电容,34,0.345,0,995556,0,0,0.657,76534503483,0,-58,-0.59,-11044354,1160782296,18333798,-29378152,1.714,75546083903,0
801097,流感,-1,-0.02,0,25730246,0,0,3.629,405912466893,0,-39,-0.398,5490298,3555778303,73701823,-68211525,1.052,404048940061,0
801099,覆铜板,0,0.007,-831449,37995024,331288,-1162737,1.572,273684007101,0,-167,-1.676,-57635268,4361038805,189383295,-247018563,0.812,269186741508,-10846600
801100,多胎概念,-21,-0.127,3381978,109671673,8863357,-5481379,3.292,625926284909,0,-73,-0.735,-113490971,10930153187,423971125,-537462096,0.926,625740013102,-23508800
801102,涤纶,-8,-0.089,-1312713,11145653,843183,-2155896,1.343,414555033352,0,-53,-0.534,-1780040,2424835526,348406536,-350186576,0.871,415463949110,25207600
801104,开板次新,0,0.0,0,0,0,0,1.0,0,0,0,0.0,0,0,0,0,1.0,0,0
801112,互联网金融,-51,-0.516,33979709,244231963,85397454,-51417745,3.606,984995970400,10341300,-212,-1.528,-797595391,20065957532,3013195580,-3810790971,1.024,974719225540,-125086000
801114,外贸,4,0.044,2153438,120402448,5829237,-3675799,1.552,823742305664,0,-72,-0.729,48497517,16303685451,749954604,-701457087,0.917,815733365794,61479200
801115,海南,-47,-0.48,-1394055,81409432,5422253,-6816308,3.668,413706767544,0,-48,-0.485,-57504995,6889130030,352380794,-409885789,1.289,412993967916,429630
801117,港口,-1,-0.012,-1276840,7359402,402000,-1678840,1.848,413272315890,0,10,0.103,-27602173,1328275162,278839590,-306441763,1.102,413971915333,-11465400
801120,电力,-2,-0.026,-8225228,73676870,24652377,-32877605,3.598,2003272681450,-3026930,-40,-0.403,-409179603,11151920167,1770883770,-2180063373,1.14,1996071676910,-100399000
801122,壳资源,-8,0.239,-1288013,185809493,7291923,-8579936,4.202,366198019200,0,-48,-0.126,2675558,11444502312,962742813,-960067255,1.047,364400382272,8217380
801123,服装家纺,-9,-0.095,-279494,54327990,6822077,-7101571,3.494,475164014813,0,-67,-0.673,-172984730,6520662185,577267135,-750251865,1.098,472910533224,-1940850
801126,期货概念,-30,-0.306,-1049319,33327317,1959289,-3008608,1.65,677607404928,0,-44,-0.441,-209096184,5907125244,905992600,-1115088784,1.114,672764791855,-78230100
801127,海航系,-19,-0.195,0,1396085,0,0,1.813,22585916824,0,29,0.293,7084891,206097673,40466081,-33381190,1.366,22661458079,0
801128,国产软件,-31,-0.314,-5542841,212695272,20545882,-26088723,1.104,1777809694983,3823420,-178,-1.783,-674328200,34926448335,2265529609,-2939857809,0.859,1756375899674,-143063000
801132,粤港澳,-38,-0.386,4055931,143881524,18221524,-14165593,3.202,542969693188,3772270,-101,-1.015,-171631949,9788792330,390503232,-562135181,0.996,540528060422,14047600
801136,安防,-44,-0.442,-3522518,34601566,2965620,-6488138,2.258,449629261276,0,-134,-1.35,-117687143,4880773629,594635645,-712322788,1.018,453413786842,-20459300
801137,醋酸,-25,-0.257,-959248,2033568,0,-959248,1.288,105990423694,0,-83,-0.84,-75333785,568566637,120716941,-196050726,1.006,105380282152,-9675460
801138,超级电容,5,0.059,0,14710929,0,0,1.397,319093613030,0,-143,-1.437,-5323949,3792803535,9041573,-14365522,0.941,314491587293,0
801139,培育钻石,-28,-0.289,0,9561169,0,0,3.746,106953738672,0,-65,-0.652,-5624232,1122258592,21324657,-26948889,1.058,107031379405,0
801142,蚂蚁金服概念,-22,-0.226,-9877594,161809861,2350865,-12228459,3.406,2677558537310,0,-101,-1.015,-339023714,17862726715,864303421,-1203327135,1.143,2668258598332,-33581900
801144,医美,-20,-0.208,1481053,53860359,4155437,-2674384,2.867,771138519751,0,-76,-0.763,-125605975,8939424725,663156487,-788762462,1.005,769632060218,-37464000
801146,阿里巴巴概念,-35,-0.35,4306072,218827129,12207908,-7901836,1.818,878120583145,3772270,-163,-1.637,-103937729,22442592095,223272226,-327209955,0.879,867574158456,5715150
801148,碳中和,-17,-0.177,-611517,182561484,5201635,-5813152,3.091,3557635218566,0,-52,-0.525,-122979036,27350226890,951536519,-1074515555,1.195,3548634038399,-661826
801149,社区团购,-55,-0.552,-1060740,27114494,0,-1060740,1.706,194908545586,0,-75,-0.757,-44365739,3137714199,65864396,-110230135,0.75,194563881136,-9844300
801153,创投,-19,-0.129,-796603,178061951,6953264,-7749867,2.501,1147217304704,0,-78,-0.578,-169852738,19632496107,593020204,-762872942,0.985,1140748982400,-11607300
801157,智慧停车,-38,-0.382,-4990654,31604981,4853680,-9844334,6.546,89755736135,0,-149,-0.893,-59559276,2253479472,257623351,-317182627,1.986,88899799488,-11483500
801159,机器人概念,13,0.166,-6417402,485256755,28583872,-35001274,2.792,2833443354112,1604060,-57,-0.575,-436154811,52292919046,2031429419,-2467584230,0.965,2812837049639,-37134300
801162,超跌,-15,-0.128,-3263084,462689733,8317368,-11580452,3.527,2300082631808,0,-77,-0.67,-209900910,43897837524,1206428220,-1416329130,1.057,2285988273984,-26060500
801164,自行车,16,0.165,0,1891242,0,0,0.623,45746846470,0,-79,-0.797,-2676123,573576176,3649017,-6325140,0.665,45316751216,0
801165,氢能源,25,0.417,4784052,460221008,55912351,-51128299,3.014,5931802696896,-3679100,-14,0.086,11024676,45544071816,2343777554,-2332752878,1.033,5902965220622,30707700
801166,上海国资改革,-9,-0.092,0,26747598,0,0,2.378,522265475535,0,-39,-0.394,-40239840,2725155853,45688661,-85928501,1.077,521930753179,0
801168,工业气体,9,0.095,0,1897451,0,0,0.591,79228651659,0,-173,-1.732,-16679109,669028589,38689072,-55368181,0.753,77471800098,-3045800
801169,VR/AR/MR,-11,-0.12,-1974711,262663210,10935280,-12909991,1.741,1669891000512,0,-142,-1.349,-460090647,35319478884,1120771533,-1580862180,0.929,1646438112697,-68265600
801170,金融科技,257,-0.179,39361,133244975,550079,-510718,2.32,526570256896,0,185,-1.394,-72713111,11717828923,111974728,-184687839,0.923,522206121410,-3017370
801175,聚丙烯,16,0.161,0,8115710,0,0,0.881,1287876907649,0,-6,-0.069,-13968920,2511402556,30570043,-44538963,1.148,1280972071541,0
801178,储能,2,0.05,4030636,499519518,12149260,-8118624,3.136,5626803545280,0,-62,-0.593,-94447951,59213331356,3382312021,-3476759972,1.041,5581708004505,113644000
801182,雄安新区,-59,-0.591,228720,236657114,9767229,-9538509,6.456,796672153689,0,-140,-0.802,-105388332,16084569894,419135277,-524523609,1.457,793873705103,3396390
801184,包装印刷,-4,-0.049,-1211572,65219608,0,-1211572,1.961,358611040929,0,-111,-1.111,-57127255,6058154985,158191706,-215318961,0.832,355144479756,-1366720
801190,卫星导航,16,0.161,4627472,66419125,10395364,-5767892,1.268,826553716839,0,-61,-0.617,-73605062,13486041159,959213590,-1032818652,1.007,820069267587,-1072120
801193,知识产权,-29,-0.3,-633468,73754315,314050,-947518,1.569,330102818227,0,-144,-1.447,-233445233,11297431152,411051299,-644496532,0.854,327259004028,-54896500
801196,LED,-13,-0.135,-325000,14985699,0,-325000,1.202,244898724489,0,-145,-1.455,-17620354,2653870645,27306469,-44926823,0.871,240689033830,0
801198,送转填权,-67,-0.072,-4616597,236734723,29765895,-34382492,1.434,1777707543642,1604060,-255,-1.299,-409919441,37413957371,1621129506,-2031048947,0.963,1754840503698,4344940
801199,汽车零部件,4122,0.992,156037518,1631205485,499258657,-343221139,5.206,7662370572416,63728200,6505,0.334,391944967,122692000292,10299772444,-9907827477,1.231,7581082864768,31116100
801200,互联网医疗,-29,-0.299,-692010,50790951,0,-692010,2.566,386170506836,0,-132,-1.325,-19934684,5459131793,172240260,-192174944,0.914,382093170294,0
801202,世界杯概念,-18,-0.187,-1042079,62699991,1214808,-2256887,2.726,302832750550,0,-117,-1.177,-29170110,6583492293,58652726,-87822836,1.003,300360890149,0
801209,振兴东北,-1,-0.018,0,6152327,0,0,1.396,237842485052,0,-64,-0.641,-7268554,1515871992,13807644,-21076198,0.927,238174790282,0
801210,操作系统,27,0.271,4594700,92532130,12276867,-7682167,1.149,728888644256,0,-111,-1.112,-229586404,13829850634,1053879999,-1283466403,0.784,719730912260,-5870460
801211,新疆,-26,-0.268,-1044340,25711850,3417436,-4461776,1.966,289340191738,0,-67,-0.677,-13719181,3308738754,89074238,-102793419,1.226,289104866324,9911520
801215,徐翔概念股,-39,-0.394,0,6292074,0,0,2.423,22314513283,0,-152,-1.526,-3353224,924675550,12223985,-15577209,0.983,22035062410,0
801216,印制电路板,-24,-0.246,-852256,77983539,6088051,-6940307,1.28,470982323374,0,-191,-1.911,-238420104,9629466926,730639111,-969059215,0.813,462518209243,-47565200
801218,华为概念 ,-5,-0.055,16529949,786075566,45461966,-28932017,1.609,6049911786688,12698100,-128,-1.289,-498969016,98960170058,3323979539,-3822948555,0.916,5967336099329,83711500
801220,食品饮料,-161,-0.418,-2328956,196028583,23849764,-26178720,1.979,2102827868036,773295,-185,-0.654,-262378053,24526172909,2045953628,-2308331681,0.923,2096834689384,6041690
801224,3D打印,3,0.032,-786857,31369061,934365,-1721222,1.308,167740883430,0,-44,-0.442,-26406489,4744989462,201042297,-227448786,0.753,165223818448,-3121130
801227,烟草,-21,-0.214,0,23589789,0,0,1.397,194784081135,0,-98,-0.984,-6820725,2739183971,26614042,-33434767,0.647,194588953638,0
801232,环球影城,-124,-1.244,0,34271201,0,0,7.643,38893195967,0,-220,-2.202,0,2071241864,0,0,1.567,38812236230,0
801234,航运,3,0.038,-411302,16739705,326698,-738000,0.998,643014714168,0,-41,-0.416,-64750450,5997651375,419968467,-484718917,1.115,644309684662,6001630
801235,化工,270,-0.024,-17104145,335032903,31086843,-48190988,1.85,8257732103776,0,-201,-0.811,-929490117,52831028725,4032029776,-4961519893,0.993,8208387129016,-33615800
801241,核污染防治,3,0.033,0,13335219,0,0,4.575,193233690145,0,-54,-0.541,4514864,1627117790,84536167,-80021303,1.172,192731990955,3024340
801243,宠物经济,-19,-0.199,0,741083,0,0,0.563,38564670906,0,-76,-0.761,6476250,327340537,28438097,-21961847,0.77,38510436591,0
801246,水务,-19,-0.192,-312988,14853642,1459368,-1772356,1.95,119554748565,0,-87,-0.873,-43535585,1454458296,86187346,-129722931,0.962,119096227722,-3188640
801248,智能驾驶,949,1.091,50202756,1163646496,116206428,-66003672,3.562,3754429126720,11297400,979,-0.081,60107872,75422542265,3007905634,-2947797762,1.12,3715466411979,-91286100
801250,并购重组,923,0.035,-2265778,2166582634,48447155,-50712933,4.511,16962929902656,-2629100,743,-0.458,-478807658,200703719534,3055818954,-3534626612,1.1,16872018611712,-59326200
801251,送转预期,-31,-0.318,-257986,23641573,2798129,-3056115,1.995,143300535400,0,-278,-2.181,-93207945,3382045992,198679405,-291887350,0.98,140492766303,-11617000
801253,数字能源,12,0.122,222384,120917465,1107984,-885600,1.892,1159793216000,0,-57,-0.574,115201872,8858663238,349841473,-234639601,1.048,1141474262834,65360100
801254,防脱发,-10,-0.102,0,5378872,0,0,0.731,177747253816,0,-58,-0.58,-10495442,1699051124,4596786,-15092228,0.808,176859583505,0
801270,基础建设,-246,-0.665,9574956,751144932,102393327,-92818371,4.549,3678516874560,11504900,1123,-0.916,-714945014,57246721084,6505108424,-7220053438,1.285,3661790736768,-12386900
801273,股权转让,-10,-0.005,-311481,1318166057,32743351,-33054832,4.069,7347255912512,-4233160,-67,-0.539,-518188758,119548906115,2154447426,-2672636184,1.142,7306926012352,-110360000
801274,西藏,-16,-0.168,0,15784420,0,0,0.773,156914671033,0,-112,-1.122,-3363183,2240161175,15019588,-18382771,0.748,155695700761,0
801279,砷化镓,-4,-0.05,0,6570156,0,0,1.102,115939885570,0,-48,-0.482,-2914780,1421242593,19131428,-22046208,1.011,114877250831,0
801284,举牌,-9,-0.092,1189783,70928216,2810068,-1620285,1.481,752454614144,0,-61,-0.141,-14168721,9673316420,190510399,-204679120,1.003,751296809088,-3060000
801287,养老概念,-44,-0.442,-12204,26156198,1763088,-1775292,1.936,197934598198,0,-95,-0.954,-63240971,3430353901,122316457,-185557428,0.865,196889919803,0
801301,体育产业,-17,-0.171,-59100,244376698,3436000,-3495100,3.025,1787390118729,0,-76,-0.769,-87744705,22436336739,324219677,-411964382,1.129,1783519682811,-6201530
801306,深圳,-22,-0.172,101811,457809316,12658855,-12557044,2.316,6351335789371,0,-149,-0.891,-462391113,61329603425,1455195879,-1917586992,0.995,6324084744098,-76796000
801310,浙江,-16,-0.169,-1615603,187349455,3141754,-4757357,2.176,1825529332352,0,-140,-0.716,-133267850,22671825292,521381615,-654649465,1.044,1818063099353,-12413900
801313,参股金融,-32,-0.294,3480840,349111124,25812523,-22331683,4.116,4094478952642,11207900,-69,-0.691,-99046520,37714171975,1457300124,-1556346644,1.251,4107647864506,55788500
801314,ST板块,243,-0.066,-2398033,71937364,5487551,-7885584,5.272,362921328201,0,89,-0.109,-76637127,3770096435,368378726,-445015853,1.029,362719415816,-3184260
801315,高校,-7,-0.075,-327712,43426712,0,-327712,2.502,478095387736,0,-71,-0.715,-79343616,7071248237,156302169,-235645785,0.866,473662123044,-21735400
801319,福建,3,0.032,0,177260105,0,0,2.244,1648611303680,0,-63,-0.638,-6396469,14520605275,55831134,-62227603,1.137,1621767017411,0
801321,广电网,-22,-0.229,2990899,35255384,11549452,-8558553,3.012,226518356841,0,455,-0.447,14058221,3904275283,542877125,-528818904,1.17,226166988010,42068400
801328,消费电子,12,0.176,4215227,640516938,54936151,-50720924,1.805,4560932510251,-4211520,-120,-1.137,-702288003,62773894378,2914758428,-3617046431,0.875,4503994101386,-182027000
801329,白银,-13,-0.134,-1345126,17664627,0,-1345126,2.187,253381123210,0,-76,-0.767,-35243905,2061596340,200916315,-236160220,1.015,250652337029,-28534600
801330,旅游,-55,-0.552,-1203183,89276557,17744960,-18948143,3.229,565528148266,-2093910,-29,-0.295,403400697,13670803184,2915513169,-2512112472,1.197,572001707093,58345000
801332,大麻,0,0.305,2625837,110913924,4977771,-2351934,8.411,411655667362,0,-54,-0.367,-15621727,5163107488,184514952,-200136679,0.913,409380088438,3705590
801342,超高清视频,-12,-0.125,-591231,134936886,845154,-1436385,1.674,1508516855368,0,-101,-0.879,-207486738,21373198464,606440062,-813926800,0.963,1504330401124,-21725000
801346,智能电网,4,0.049,-1655302,331402002,18851438,-20506740,1.572,4402209440384,1604060,-41,-0.386,-101878303,49535801071,2138479392,-2240357695,1.059,4373459704192,-25551600
801350,一带一路,-17,-0.179,-3446006,366100753,9897392,-13343398,2.246,8164699398720,0,-56,-0.568,-397567826,56432119016,1992622082,-2390189908,1.15,8124190823380,-14532200
801351,科创板,3,0.056,15006763,351451469,149244904,-134238141,1.435,3418955998912,-8785190,-670,-1.308,-768321103,47454831182,4342934126,-5111255229,0.972,3375651885624,-108909000
801358,大飞机,23,0.233,-1556899,48245211,806999,-2363898,2.029,1080211536912,0,-30,-0.304,5800397,10050038942,415797677,-409997280,1.204,1072035447133,11270600
801359,华为海思,-2,-0.023,0,5490793,0,0,0.405,237480568243,0,-115,-1.159,-54293002,2902592321,57336079,-111629081,0.917,234979899810,0
801363,黑龙江自贸区,-29,-0.293,0,7495879,0,0,1.692,53834732378,0,-57,-0.578,15771394,937004682,31575362,-15803968,0.949,53355527281,3024340
801366,业绩增长,-3,-0.006,18139985,1309920697,58022155,-39882170,3.434,13150557200896,-4233160,-61,-0.572,-377583296,139969315764,3588809968,-3966393264,1.091,13103238366016,-153534000
801369,病毒防治,-7,-0.074,1320392,354589377,19764900,-18444508,2.348,4973069520320,0,-71,-0.675,-384760947,52048669233,3291518087,-3676279034,1.01,4949830793700,-59406300
801371,垃圾分类,-18,-0.189,0,22032962,0,0,5.537,149770321506,0,-10,-0.106,-27575314,2369462997,71019401,-98594715,2.008,149638420922,0
801374,造船,-18,-0.183,204640,23029361,3457781,-3253141,1.203,409345239131,0,137,1.374,311990586,9498303443,1928751049,-1616760463,1.91,418243878833,162557000
801375,新材料概念,0,0.118,121590,180551622,5501436,-5379846,2.624,2494934436096,0,-87,-0.625,-34070369,24132675691,663698053,-697768422,0.949,2472959653248,24482300
801376,健康中国,-5,-0.056,-389610,70717812,0,-389610,1.091,1673195296996,0,-57,-0.576,-9567281,15959273550,149238927,-158806208,0.865,1669204161964,0
801377,金刚石概念,-2,-0.03,0,1220313,0,0,0.413,67026611633,0,-100,-1.006,-17018059,732012106,32587546,-49605605,1.064,66694285031,0
801378,电梯概念,0,0.006,3741344,14167320,5810490,-2069146,2.179,75608746276,0,-70,-0.701,9808621,1253884004,74263036,-64454415,0.698,75231748666,0
801379,碳纤维,8,0.086,0,9652180,0,0,1.128,313529934401,0,-74,-0.743,-22767752,2189179728,67676333,-90444085,0.858,310413516075,0
801380,生鲜电商,-19,-0.193,0,3005516,0,0,0.569,279879354650,0,-72,-0.721,-25757074,1115797781,21947945,-47705019,0.814,280650066670,-18176800
801382,分拆上市预期,-3,-0.035,398095,56444636,398095,0,1.47,1837677873513,0,-66,-0.666,-15149923,10982121760,38823302,-53973225,0.961,1833004654628,-3781800
801386,轨道交通,11,0.261,1357242,160571043,6311482,-4954240,2.425,2632776266560,0,-54,-0.385,-46809003,20215453444,667382671,-714191674,1.035,2611855775168,14862900
801388,VPN,-13,-0.132,0,16097815,0,0,1.335,230603102802,0,-97,-0.976,-524510,3470823736,4861834,-5386344,0.82,228546193692,0
801391,美容护理,-15,-0.158,-1610000,14129586,0,-1610000,1.259,311560181256,0,-67,-0.677,-9533370,3102397340,308770512,-318303882,0.802,311677475363,10307700
801396,云游戏,7,0.076,-839703,32031529,1354021,-2193724,1.158,145882223400,0,-101,-1.01,-160116889,6004540290,503918515,-664035404,0.903,144682659451,-29424400
801399,智慧城市,-146,-0.263,2325440,296630252,30278144,-27952704,2.609,2426450816147,8436000,-397,-0.975,-135430967,38273971076,867779508,-1003210475,0.965,2408066258076,20371800
801407,上海,-9,-0.094,-307080,74657010,2753668,-3060748,2.66,1169605046144,0,-70,-0.543,-115660419,11210302709,516031641,-631692060,1.278,1162394379136,-74983700
801408,智能家居,-14,-0.149,-3431974,107166740,5184114,-8616088,2.261,1586416564163,0,-124,-1.241,-112750965,14443297804,280445603,-393196568,0.936,1574528731415,0
801411,柔性屏,-16,-0.162,684715,54639138,684715,0,0.828,754001392354,0,-93,-0.936,-22306001,11429403489,152501689,-174807690,0.814,748017932176,5207400
801412,新零售,-56,-0.569,108518,139664721,606000,-497482,2.648,1044706937344,0,-105,-0.935,-102095060,14957257957,216162784,-318257844,0.914,1041870115413,-34387700
801414,教育,-22,-0.221,-21804,208535697,1581868,-1603672,1.579,1030548857195,0,-117,-1.174,-136777653,28857965416,365105753,-501883406,0.901,1020497318677,-11514100
801415,电子发票,-13,-0.131,0,1971215,0,0,0.649,71063374978,0,-179,-1.794,5069811,740646889,11060732,-5990921,1.058,70024999075,0
801417,天津自贸区,-138,-1.385,0,29890234,0,0,7.535,56682344539,0,-107,-1.078,14448614,1702358438,84049068,-69600454,1.554,56694768364,0
801418,民营医院,-17,-0.178,-305538,50608041,885118,-1190656,2.034,725067087322,0,-67,-0.674,-61893910,6786187766,161366890,-223260800,0.974,723178781840,-12936800
801419,通用航空,-7,-0.077,-1648141,44056971,715757,-2363898,5.928,342985522944,0,-13,-0.137,-37069468,4119518670,210143812,-247213280,1.543,342032158622,-6950120
801420,蓝宝石,-15,-0.155,-2328150,37324495,521730,-2849880,1.123,723726454834,0,-165,-1.651,-9592100,8903339025,57442862,-67034962,0.771,711811552022,0
801422,小金属概念,-4,-0.045,-2328150,124968750,521730,-2849880,1.731,2258745674880,0,-65,-0.655,-35726221,20896625818,162111324,-197837545,1.097,2242089628794,-3211070
801427,福建自贸区,-50,-0.508,0,26407128,0,0,3.435,112028035914,0,-59,-0.593,-5842066,2415586129,39484138,-45326204,1.265,112539036058,0
801430,智能交通,14,0.377,545412,314665392,1904627,-1359215,3.185,850179422961,0,-93,-0.461,-10338566,12960755984,99630688,-109969254,0.992,852197955787,-5805070
801433,光学镜头,28,0.284,1311000,28512577,9750850,-8439850,1.322,284840035441,0,-128,-1.283,-257523386,4409758005,530616645,-788140031,0.835,280275417050,-51315700
801437,传感器,24,0.669,13179523,368613695,38796983,-25617460,2.9,809732193408,-683568,-108,-0.196,-333130584,19432241461,1147708816,-1480839400,0.976,800453007498,-135324000
801439,网红经济,-25,-0.254,-210591,224580955,5462744,-5673335,1.952,1221571273563,0,-116,-1.165,-382965784,30760594042,1050389951,-1433355735,0.872,1213339994696,-11848800
801443,转基因,-39,-0.399,0,7931421,0,0,0.75,132460394963,0,-140,-1.407,-77798146,1773702153,107789217,-185587363,0.714,131308421721,-7341750
801445,元器件,-2,-0.029,445951,15119429,445951,0,0.614,497720950243,0,-104,-1.049,-34116743,5838889005,163486494,-197603237,0.707,491888911922,-11101900
801450,年报预增,3,0.034,-3171818,159985295,3316320,-6488138,2.439,1714608020531,0,-81,-0.817,-25739620,20398517797,230744673,-256484293,0.979,1701988783021,0
801451,wifi6,-52,-0.527,-1171558,32364749,0,-1171558,1.468,94629957902,0,-172,-1.725,-21879736,2744770723,48273997,-70153733,0.813,93531654728,-3013240
801452,再融资,0,-0.004,-4219616,163509713,5079066,-9298682,1.531,2319851127926,0,-78,-0.787,-150184097,26280169247,321231801,-471415898,0.89,2299730244973,-7152740
801457,武汉,-14,-0.141,-1040361,87584786,1714008,-2754369,4.436,565889456256,0,-96,-0.767,-23716501,10050473342,154313150,-178029651,1.185,559215251208,-3010970
801461,C2M,-29,-0.292,584667,44253553,584667,0,3.436,269711650786,0,-111,-1.119,-18425197,4364382392,81483194,-99908391,0.998,268025312899,247293
801462,RCS,-9,-0.091,-941779,29056314,502500,-1444279,0.811,502436428544,0,-76,-0.767,86451013,7544729937,509898722,-423447709,0.845,499509602892,31378900
801464,农业,-27,-0.274,-1939701,199180984,17800771,-19740472,2.203,2265704174465,0,-446,-0.867,-455733329,25935338895,2397662209,-2853395538,0.903,2257892554563,-137572000
801467,REITs,-54,-0.54,6048,55378146,317520,-311472,3.939,783840810972,0,-74,-0.746,-85838161,6670980003,99941051,-185779212,1.273,782419609172,-11192100
801468,电子烟,3,0.031,4671044,53106631,8113984,-3442940,1.413,413150629272,0,-116,-0.88,-16630854,7617197112,721993714,-738624568,0.777,411370514490,-5276060
801471,免税,-54,-0.541,-4313102,49538210,12242000,-16555102,1.525,753415266536,-2093910,-39,-0.395,186735597,9159038120,2087799284,-1901063687,0.862,760180313863,33882600
801479,NMN,-1,-0.016,0,4879583,0,0,0.84,126691329514,0,0,-0.006,-24477753,1450382563,66957237,-91434990,0.975,126492747154,-3835370
801493,光储充一体化,27,0.271,3020460,11312853,4009652,-989192,1.073,136281868435,0,-72,-0.728,-43483347,1890727521,145934851,-189418198,0.765,134710424107,3913480
801511,高端制造,3,0.036,-7825833,300722944,12719966,-20545799,1.77,1878537482147,0,-197,-0.74,-572013750,33981657316,1603102231,-2175115981,0.866,1860678584056,-171346000
801519,汽车类,566,0.822,90462472,1954377643,365854480,-275392008,5.064,9616381736256,18979300,487,0.08,42384630,147259818575,9294384996,-9252000366,1.146,9513888648960,95152200
801522,专精特新,10,0.227,14030602,581738724,33264849,-19234247,2.258,2223441427520,8360000,-76,-0.679,-45474411,46028203333,1698000107,-1743474518,1.086,2205673210499,22207200
801529,激光,-4,-0.047,0,33242501,0,0,1.298,251538608560,0,-162,-1.628,-17760762,5425605046,50155145,-67915907,0.774,247274551279,0
801530,中字头,-14,-0.144,-384355,184398356,421355,-805710,1.382,8074750536207,0,-38,-0.383,19308992,38984763964,419857070,-400548078,1.128,8088061300476,3240350
801541,生物质能,0,0.004,0,30778076,0,0,3.2,414328304819,0,-59,-0.597,-8463612,4158477419,18475336,-26938948,1.334,410722389440,0
801543,水电,0,-0.01,451335,17632475,7133723,-6682388,1.507,1019162672302,0,-30,-0.305,-178830970,2499999928,435340161,-614171131,0.982,1015093916577,-66312900
801546,钒电池,7,0.078,-247962,20624802,698767,-946729,1.697,481087997807,0,-62,-0.623,-28237514,4138478770,298637821,-326875335,1.37,478585909641,-32267900
801547,碳基材料,18,0.188,0,4609528,0,0,0.999,136054426776,0,-93,-0.936,-8774552,1238762934,15216756,-23991308,0.941,134025094075,0
801550,国资云,-18,-0.185,3972898,76804817,7072272,-3099374,1.191,778049968575,3904500,-83,-0.84,-100015400,15738696177,367621969,-467637369,0.954,773712125066,-20470100
801553,元宇宙,-10,-0.106,4077543,470227788,9996858,-5919315,1.544,3217202789056,0,-417,-1.128,-318903015,67655927484,1207279102,-1526182117,0.894,3191252373616,-1945320
801564,绿色电力,-3,-0.038,-3581320,61660129,1534002,-5115322,1.24,2366481571528,-3026930,-49,-0.499,-240791336,13028059273,1018746648,-1259537984,1.081,2358625117197,-23507300
801565,海工装备,2,0.029,-312223,27641604,0,-312223,0.966,708642457695,0,11,0.117,-12214160,11101614250,66415051,-78629211,1.52,714526944691,0
801567,NFT概念,-23,-0.23,0,23355238,0,0,1.218,197858792966,0,-103,-1.031,-10733651,4833945116,63318605,-74052256,0.945,196256769174,0
801572,中报增长,-4,-0.021,18694083,1443665086,59808538,-41114455,3.685,13630450690944,-4233160,-64,-0.605,-419680346,151417053320,3679808602,-4099488948,1.106,13582721881984,-153534000
801575,智慧矿山,10,0.103,-813175,4830127,0,-813175,1.008,93395414122,0,-108,-1.088,-54637171,1386253429,79218916,-133856087,0.807,92836588564,0
801576,石墨化,8,0.086,-590240,39899703,321440,-911680,1.434,872351656464,0,-76,-0.766,-43569089,8275591498,79575000,-123144089,1.076,869438716839,-911687
801578,铀矿,30,0.309,0,2367598,0,0,0.94,94241634823,0,34,0.349,0,782953418,0,0,1.388,93968318570,0
801579,垃圾发电,-8,-0.086,-2699128,35189636,3199314,-5898442,5.245,318139795448,0,-50,-0.501,3099500,3049938041,458311583,-455212083,1.478,317055619706,-9772400
801580,发电机,19,0.199,-327242,7239463,410758,-738000,1.574,128512682922,0,-75,-0.756,-48451404,1227024650,89307616,-137759020,1.048,127644150352,0
801584,数字经济 ,-18,-0.172,29082129,1393237214,210810811,-181728682,2.448,9271531554688,13061500,-240,-1.129,-2073830052,172990472881,10492099859,-12565929911,1.028,9196169841217,-213217000
801587,光热发电,-2,-0.024,0,11792565,0,0,0.869,287668757582,0,-15,-0.157,1963886,2816953244,57604429,-55640543,1.073,286473058299,3044680
801606,成渝经济圈,-110,-1.11,413860,15802005,3678263,-3264403,5.059,42372362121,0,-3,-0.036,-32410038,970938686,101793712,-134203750,1.219,42541350199,-1125740
801612,脑机接口,-14,-0.149,945354,19786559,1263112,-317758,0.94,221125669367,0,-100,-1.007,-50862092,3897028956,158025306,-208887398,0.716,219099101473,-2925030
801613,幽门螺杆菌,7,0.072,497610,4793305,497610,0,1.945,109943995115,0,-18,-0.184,-10465053,1149297487,37043581,-47508634,0.942,109707941200,0
801614,电子纸,48,0.482,4016500,11193306,5118500,-1102000,0.82,107139396786,0,-75,-0.758,-5131572,1496679497,63433237,-68564809,0.761,106876538759,0
801623,中俄贸易,1,0.015,19758,23884107,373758,-354000,1.819,337748129335,0,-3,-0.036,-28137997,4156156275,255448511,-283586508,1.118,337314226880,2968470
801625,在线办公,-33,-0.339,0,64744427,0,0,1.274,488094510637,0,-147,-1.478,-1978088,9371375275,33696918,-35675006,0.744,482454483022,-49791
801628,资产管理,-15,-0.16,0,21574274,0,0,2.891,203406546944,0,-31,0.179,-7210224,2199454813,110958125,-118168349,1.178,203045254528,-12653400
801631,次新股,-266,-0.181,30572178,634968972,158905251,-128333073,3.279,505625426048,-8785190,304,-1.219,-311047015,42082306902,1966483081,-2277530096,0.978,499491606944,-46947800
801632,县城城镇化,-179,-0.915,-3658199,392378246,13957512,-17615711,11.944,280586466048,0,-454,-1.248,-163185528,15693715929,597413798,-760599326,1.481,278560592220,-3719270
801635,平台经济,-33,-0.335,5335160,500342219,37366934,-32031774,2.918,3549812046176,4035600,-95,-0.919,-512707793,58094268423,1386815976,-1899523769,0.962,3544220145393,-41858100
801636,露营经济,-1,-0.013,2479141,22545940,2983141,-504000,5.961,82561301310,0,-63,-0.631,-10126553,1480986852,47563764,-57690317,1.539,81961120575,-229265
801637,潮玩,-38,-0.381,8671950,53053470,25247250,-16575300,4.957,52440976477,14444800,-160,-1.6,-40476038,3221584932,503386533,-543862571,1.071,51963504965,-12499600
801640,就业概念,-11,-0.117,-327712,4706746,0,-327712,0.694,83145357890,0,-140,-1.404,-95455,1882415584,35336641,-35432096,1.31,81934678444,0
801642,石英材料,-34,-0.346,0,3178951,0,0,0.734,206030983142,0,-100,-1.006,-65358729,1495885347,98794037,-164152766,1.131,201886663847,-8133630
801646,信托概念,4,0.044,0,29317527,0,0,4.299,605954209582,0,-38,-0.381,-12112223,3160858569,112957279,-125069502,1.184,605656760688,-12653400
801648,数字藏品,-42,-0.429,0,64614631,0,0,1.54,333319203578,0,-97,-0.976,2124386,9033574000,9095239,-6970853,0.785,331171298836,0
801649,两轮车,-1,-0.011,0,12954678,0,0,3.564,114747425135,0,-53,-0.54,-20547352,1354110272,57350940,-77898292,0.863,114391470263,0
801650,SHEIN概念,27,0.273,0,5922507,0,0,4.544,25493019786,0,-65,-0.65,-3366340,340929040,5468644,-8834984,1.032,25260826626,0
801651,湖南,-9,-0.097,524568,95029501,1850063,-1325495,1.522,1262364011328,0,-60,-0.604,-84224867,19657144241,438115827,-522340694,1.082,1256504585288,32614600
801653,霍乱概念,2,0.024,0,850100,0,0,0.546,52305225308,0,-95,-0.952,-1748913,373417151,13991202,-15740115,0.791,51717619002,0
801654,眼科医疗,-11,-0.118,0,19761094,0,0,1.045,788189329703,0,-28,-0.28,-21602749,5986497494,64365428,-85968177,0.846,787798461249,0
801655,隐形冠军概念,9,0.096,0,55209155,0,0,0.849,1004760175090,0,-124,-1.25,-43391313,10432347716,89810256,-133201569,0.938,991437997413,0
801656,热泵,23,0.235,0,8574932,0,0,2.103,129381457897,0,-48,-0.481,-15017275,1720827885,25739455,-40756730,1.166,128656755012,0
801660,通信,-2,-0.027,5146374,489000911,95798302,-90651928,1.678,4069669446528,13202300,-120,-1.071,-1468548823,68925817237,6042919980,-7511468803,0.913,4021600870438,-653964000
801662,火电灵活改造,-26,-0.261,77464,4760486,511935,-434471,0.768,195187539776,0,-22,-0.226,11564376,1727266648,104883854,-93319478,1.59,194834477130,-3222620
801664,中芯国际概念,-8,-0.081,641944,40820994,641944,0,0.657,1171101786097,0,-169,-1.697,-53487369,11570108821,81735771,-135223140,0.922,1154357661581,-5770490
801672,web3.0,-33,-0.334,0,101855080,0,0,0.979,607312213923,0,-136,-1.362,-22882148,21194274522,53424702,-76306850,0.916,603545987690,-5544940
801676,地产链,362,-0.732,-15021010,1527266705,235140812,-250161822,9.01,4572654503392,-4758780,2335,-0.95,-1150348303,80612449265,7006374337,-8156722640,1.426,4562588084640,-31402600
801689,客运,-1,-0.013,-555985,4629566,0,-555985,1.601,312130989566,0,-75,-0.751,-62462018,761866833,95347202,-157809220,1.014,310348136047,-8635570
801694,非金属材料,-7,-0.072,0,1100246,0,0,0.322,85975163095,0,-118,-1.186,-95579919,738048110,105512486,-201092405,0.775,85005207893,-8133630
801700,高压快充,50,0.862,575275,60854570,1320275,-745000,1.799,243731976704,0,50,0.501,168691742,6314292677,522038608,-353346866,1.011,242446795754,60018700
801705,超导概念,6,0.062,-1916693,18474839,1341548,-3258241,3.206,179212076083,0,-21,-0.219,23731405,2176315042,117782855,-94051450,1.369,177928361854,0
801719,腾讯概念,-17,-0.174,0,118920475,0,0,1.167,1440777755243,0,-139,-1.396,3086227,24971147688,286395807,-283309580,0.866,1425652158742,-10840500
801733,中特估,-8,-0.084,-1250303,246797586,2319385,-3569688,1.217,14913512293401,0,-17,-0.177,-176752444,58328698820,1070935323,-1247687767,1.177,14961992051137,-92767900
801735,中船系,0,-0.007,0,16200170,0,0,0.992,366563842046,0,208,2.086,25567207,7457912431,75109253,-49542046,1.61,375541884728,0
801773,热力,-10,-0.1,1368229,11892594,2786818,-1418589,1.598,103999465346,0,-36,-0.365,-30413252,2109080717,107591087,-138004339,1.031,103813664350,-4182480
801787,实控人变更,576,0.761,6094019,46281694,23276670,-17182651,982.369,36902670464,14691000,1166,3.953,3361521,2277387739,107751961,-104390440,154.197,37817847548,31147800
