股票代码,板块名称,当前涨幅_0930,净额_0930,成交额_0930,主力买_0930,主力卖_0930,量比_0930,流通市值_0930,当前涨幅_1500,净额_1500,成交额_1500,主力买_1500,主力卖_1500,量比_1500,流通市值_1500
881101,种植业与林业,-0.577,3380275,31247863,8242846,-4862571,2.243,171457966000,-0.072,-59866138,3211163731,574915627,-634781765,1.018,172371236202
881102,养殖业,-0.642,-1355389,24146700,3782913,-5138302,2.126,401002067232,0.656,149742724,3790381883,955540882,-805798158,0.844,410202482242
881103,农产品加工,-0.808,-9878161,42360947,3643227,-13521388,4.551,339267713051,-0.174,-158789963,3334672440,575930744,-734720707,1.063,340685995792
881104,农业服务,-0.386,0,1795834,0,0,0.859,73696016022,-0.065,-19085750,408286789,29218505,-48304255,0.914,73868471235
881105,煤炭开采加工,-0.61,-21091880,67417448,17239919,-38331799,2.81,1216259008623,-1.029,-461534617,5341543874,1051749962,-1513284579,0.993,1202761029140
881106,石油矿业开采,-0.523,222486,11885598,3863645,-3641159,1.452,1468450284590,-1.374,-247136480,1834868915,419804750,-666941230,1.021,1452381650303
881107,油气开采及服务,-0.615,-2333457,21754124,5011210,-7344667,1.797,325399742240,-1.011,-169975825,2485893837,542809888,-712785713,1.136,324912902871
881108,化学原料,-0.649,-1273067,54860249,15979412,-17252479,2.805,509205254803,-0.594,-266315590,3896204509,538536063,-804851653,0.967,507393859509
881109,化学制品,-0.324,13511734,190470427,70007673,-56495939,4.165,1833906785780,-0.108,-586045117,17056169138,3082991765,-3669036882,1.08,1830462745369
881110,化工合成材料,-0.184,-1096183,76672554,26943983,-28040166,1.883,546737267888,-0.33,-323717951,8291016185,1544497327,-1868215278,0.945,546147291915
881111,化工新材料,-0.375,-315599,6210776,0,-315599,0.902,491711571446,-0.823,-69690153,1398230158,142024345,-211714498,0.789,485974170829
881112,钢铁,-0.156,-1812533,35522346,10860534,-12673067,4.258,769594358729,-0.753,-343993911,4158608669,805282202,-1149276113,1.32,763862582999
881113,有色冶炼加工,-0.699,-6749076,216028268,69156516,-75905592,2.111,1992921888289,-0.82,-1002852239,21321102254,4705563345,-5708415584,0.804,1986049258869
881114,金属新材料,-0.562,-2431067,36794287,8156155,-10587222,1.971,139042328534,-0.959,-319280349,3999684631,668486454,-987766803,0.795,137788381962
881115,建筑材料,-0.268,-687383,32574469,4052853,-4740236,1.778,679253181728,0.074,-146099676,4399584562,627892810,-773992486,0.821,677700654653
881116,建筑装饰,-0.188,-10898351,102827279,21080694,-31979045,2.055,1582369221589,0.214,-259660141,12065811536,2281434556,-2541094697,0.821,1582349552882
881117,通用设备,-0.377,14159043,259927631,100930299,-86771256,2.857,657379568422,-0.489,-737016546,18830249727,3372790725,-4109807271,0.936,658081220703
881118,专用设备,-0.101,14980465,156780733,53434059,-38453594,3.184,1198294825516,0.591,-41091064,18381574743,3758995269,-3800086333,1.15,1202516440788
881119,仪器仪表,0.247,620853,15518194,2337019,-1716166,2.376,148858078004,0.015,-121461096,2667120089,362858684,-484319780,1.146,147859926334
881120,电力设备,-0.376,-7171337,565308165,223178117,-230349454,1.921,5204819680394,0.079,-1360464443,73404928539,15820954213,-17181418656,0.968,5207124956275
881121,半导体及元件,-0.472,37520128,688892287,339447025,-301926897,3.095,2804009214745,-0.99,-2302420262,62158324044,15706456664,-18008876926,1.021,2795033679413
881122,光学光电子,-0.064,54979035,335409553,189402132,-134423097,3.708,844172683754,0.547,-326273520,22406903769,6278539387,-6604812907,1.136,848765038907
881123,其他电子,-0.655,44307015,152858824,95153706,-50846691,4.208,175124214121,-1.044,-344485567,8258118250,1738925742,-2083411309,0.976,174866637195
881124,消费电子,-0.33,3575365,177136471,60729015,-57153650,2.131,1502400869843,-0.12,-660404406,21434161883,5805140761,-6465545167,0.979,1486299255818
881125,汽车整车,-0.367,-326583,131909429,66721272,-67047855,1.333,1136190017262,0.677,-311665683,13038411187,3562342949,-3874008632,0.816,1136083041129
881126,汽车零部件,-0.613,9164359,371055588,127071570,-117907211,2.033,1360364795186,-1.043,-1565281511,35082152495,5751704528,-7316986039,0.77,1358310812136
881127,非汽车交运,-0.449,1334861,25754192,6776701,-5441840,1.647,407214767305,-0.515,-102087477,3264417232,466925631,-569013108,0.782,409544557014
881128,汽车服务,-1.482,-4536265,16164360,2954529,-7490794,2.814,81827196680,-1.948,-224415062,1723755660,377455971,-601871033,1.118,81151967811
881129,通信设备,-0.293,30494776,495124046,290254391,-259759615,2.931,948171052988,-0.369,-1193087826,39998112156,13007432410,-14200520236,0.957,958236547343
881130,计算机设备,-0.212,14397239,323789012,143343086,-128945847,3.038,904000435059,0.014,-70268488,29301938746,8476079622,-8546348110,1.15,905940202351
881131,白色家电,0.242,4797326,73158163,32726061,-27928735,3.448,974516574777,0.106,39445837,5815962231,1218358376,-1178912539,0.945,972098947492
881132,黑色家电,-0.538,-850395,7449539,433100,-1283495,1.201,118944972481,-1.81,-86560735,1736899202,268973435,-355534170,0.737,117235637357
881133,饮料制造,-0.578,-12855513,58173419,13592766,-26448279,1.391,4454584347135,-0.797,-352785770,11468451818,3333959339,-3686745109,0.821,4417323223088
881134,食品加工制造,-0.349,-2151755,59701029,17186400,-19338155,2.354,1034586010114,-0.283,-664698985,7196050644,1198611489,-1863310474,1.041,1030567135561
881135,纺织制造,-0.094,-350197,6577016,543269,-893466,2.063,118073834699,-0.041,-27900369,986366248,102743269,-130643638,0.967,117989845672
881136,服装家纺,-0.04,-2876932,26436145,2722381,-5599313,3.23,262269017098,-0.724,-179131888,2924822417,361756326,-540888214,1.189,260881251496
881137,造纸,-0.24,189141,11176911,2595873,-2406732,2.176,142048058221,-0.011,19447982,1446479818,243515691,-224067709,0.816,142448337613
881138,包装印刷,-0.019,9317683,38181802,20813882,-11496199,1.665,180285188700,0.675,-113217976,4273445014,884888985,-998106961,1.153,180897399838
881139,家用轻工,-0.031,2419695,42819376,14248706,-11829011,2.819,524941285569,0.42,-137241766,4743532148,529491104,-666732870,1.023,526201946086
881140,化学制药,-0.048,1813725,37859304,7027653,-5213928,1.399,1422906797926,0.027,-283320810,9086094491,1345881367,-1629202177,1.082,1419020049295
881141,中药,-0.318,-5069148,48558832,10143184,-15212332,2.462,1019081281345,0.719,224695433,9968516992,2063559297,-1838863864,1.123,1032201484330
881142,生物制品,-0.444,1350108,52513498,22632945,-21282837,1.785,723640327450,-1.017,-302651468,5463369684,995942316,-1298593784,1.077,719803892986
881143,医药商业,-0.259,957253,19689823,5519328,-4562075,1.479,302333981350,-0.372,-162317135,2756237846,365787872,-528105007,0.894,302629604369
881144,医疗器械,0.048,-127760,34895889,5662046,-5789806,1.273,1120832896896,-0.721,-115119988,7156853725,1132887409,-1248007397,1.076,1113025279546
881145,电力,-0.384,30576173,207213573,83735180,-53159007,2.101,2353149798735,-0.302,-571623803,14611207670,2860176928,-3431800731,0.707,2351960817181
881146,燃气,-0.333,82050,9159001,860860,-778810,2.742,173895356244,-0.094,-98939769,1133632929,132489197,-231428966,0.928,174020251944
881147,环保工程,-0.062,2761275,34298306,7219171,-4457896,2.244,413237270420,0.959,-22668678,5285752565,864193606,-886862284,1.183,416257737855
881148,港口航运,-0.255,-2281168,15243316,1791247,-4072415,1.498,725812968925,-0.19,-4572964,2461158795,453375821,-457948785,0.866,726770072823
881149,公路铁路运输,-0.166,-3508615,18271826,1984063,-5492678,2.298,698071808739,0.065,-94381505,2175904383,369109237,-463490742,1.094,700755199242
881150,公交,-0.849,-361640,3823957,0,-361640,1.528,32741849392,0.367,-2880878,407071454,39228862,-42109740,1.001,33195446196
881151,机场航运,-0.229,-4728366,30046071,7920078,-12648444,3.513,572714505445,0.251,113759759,2866475757,728521776,-614762017,0.972,574580555375
881152,物流,0.144,3602180,26230362,7273768,-3671588,2.175,634081810572,-0.173,-142877645,2736603947,380441002,-523318647,0.954,631939284036
881153,房地产开发,-0.658,3540571,214337191,101720941,-98180370,5.401,1165472738139,-0.314,-290719714,8801561209,2117875765,-2408595479,0.835,1168334618909
881154,园区开发,-0.463,-1054575,5804710,0,-1054575,1.763,134265233150,0.86,169553740,1273471618,453411106,-283857366,1.266,136762163502
881155,银行,-0.142,-4444737,150218769,72529564,-76974301,4.047,6719598586459,-0.354,-818101110,10210793824,3690227449,-4508328559,1.035,6692481918222
881156,保险及其他,-0.206,-18124510,63190720,13597465,-31721975,3.569,2228103123600,-0.284,-512482229,6421472186,1325808015,-1838290244,1.02,2200304416048
881157,证券,-0.277,-11021095,66013768,14761663,-25782758,1.552,2307463011211,-0.389,-765781798,9481030020,2380402787,-3146184585,0.776,2302222251525
881158,零售,-0.364,-6092156,67567911,12812548,-18904704,4.479,711518882679,0.032,-453668302,5434587469,839834975,-1293503277,1.018,710798327777
881159,贸易,0.069,-1214876,17472310,5118198,-6333074,4.994,90330453100,0.476,-33473391,1198402950,212170135,-245643526,1.07,90617664535
881160,景点及旅游,-0.587,-895821,26192826,5443462,-6339283,2.932,119013715605,-0.13,-21056182,2167044129,292408643,-313464825,0.903,119285917835
881161,酒店及餐饮,-0.516,0,7487187,610798,-610798,1.181,91766375489,-0.744,-73860233,1234232675,141536787,-215397020,0.732,90554370183
881162,通信服务,-0.002,13160788,271591993,187200191,-174039403,9.726,544816548847,0.042,-293131400,12454552342,3970257590,-4263388990,1.356,545817774327
881163,计算机应用,0.164,662466,843291469,347434815,-346772349,3.74,2578658451579,-0.019,-2065932600,66077577601,15690075674,-17756008274,1.018,2575586760204
881164,传媒,-0.605,-138203629,971257934,480471212,-618674841,6.028,1457159515557,-1.596,-3889755620,50064211081,11834282754,-15724038374,1.014,1438384787106
881165,综合,-0.252,4015697,17424877,6747428,-2731731,2.323,234612365290,-0.47,-222575171,2466059013,566729362,-789304533,1.055,233680532523
881166,国防军工,-0.303,-28610020,216181031,65731683,-94341703,2.179,1997006411824,-0.457,-551134131,24606389462,5337820661,-5888954792,0.885,2003303241283
881167,非金属材料,-0.214,-1048280,10410203,1509168,-2557448,2.476,88905070612,0.392,23486320,1062908835,254452966,-230966646,0.89,89155554894
881168,工业金属,-0.555,-3436433,87120526,25166419,-28602852,1.706,966397810920,-0.656,-500764753,9117132687,1692254427,-2193019180,0.735,959603616843
881169,贵金属,-0.94,-640624,22558393,5790685,-6431309,2.688,245983046442,0.689,240890049,3588792298,969361665,-728471616,1.049,250461758211
881170,小金属,-0.737,-4543842,143579694,48639001,-53182843,2.943,931853435532,-1.354,-896045576,11593726688,2574992902,-3471038478,0.787,925434137534
881171,自动化设备,-0.315,2012748,136038304,49285093,-47272345,2.25,640267537269,-0.309,-82986724,16271211971,4421775171,-4504761895,0.922,645154855403
881172,电子化学品,-0.366,-1587129,37082882,8403778,-9990907,2.234,222451626451,-0.597,-84464501,4443711712,829921946,-914386447,1.064,221861249187
881173,小家电,-0.056,-2107798,11610492,749646,-2857444,1.724,228950445303,-0.323,-64989295,1808882496,237879214,-302868509,0.825,228373074100
881174,厨卫电器,0.423,310992,3687214,310992,0,3.35,52925255542,1.04,15009523,599845231,77208224,-62198701,1.965,53090919203
881175,医疗服务,-0.561,-6309133,91757975,35478786,-41787919,4.597,768623415195,-1.903,-336980663,7710332779,1368080125,-1705060788,1.092,758338384132
881176,房地产服务,-0.473,-321250,2175115,0,-321250,2.069,40432570190,-0.148,-17709895,266016182,29100680,-46810575,0.846,40583818002
881177,互联网电商,-0.547,5965485,48907343,17450719,-11485234,5.708,103809817757,-1.676,-100797671,2718311334,451106739,-551904410,1.091,102766749937
881178,教育,0.005,-7953187,63342303,34578823,-42532010,5.608,83852505970,-1.054,-312801059,2598794119,497213054,-810014113,0.845,82848068747
881179,其他社会服务,-0.172,-27834,15065312,3128863,-3156697,1.738,152850431522,-0.009,-46459559,2273340834,342666404,-389125963,1.069,153361396885
881180,石油加工贸易,-0.144,3521072,25376093,11573948,-8052876,1.89,2328950347583,-0.203,-63649139,2596284277,599578443,-663227582,0.826,2307476125069
881181,环保,-0.062,-5160314,89759146,27392104,-32552418,4.516,621915047217,1.169,18297137,9400062808,1818738765,-1800441628,1.431,627786288544
881182,美容护理,-0.07,-3231023,17889402,3418762,-6649785,1.851,234652770923,-0.424,-163665365,2342207611,393075217,-556740582,0.938,232286235835
