股票代码,板块名称,当前涨幅_0930,净额_0930,成交额_0930,主力买_0930,主力卖_0930,量比_0930,流通市值_0930,当前涨幅_1500,净额_1500,成交额_1500,主力买_1500,主力卖_1500,量比_1500,流通市值_1500
881101,种植业与林业,-0.161,-1436132,9461230,1989992,-3426124,0.971,134517267230,-0.672,-36199188,1477610282,182700268,-218899456,0.716,134953906672
881102,养殖业,-0.172,-947417,18826916,2782443,-3729860,1.318,393927094845,0.381,21510138,4370815418,947651149,-926141011,0.928,398497918122
881103,农产品加工,-0.122,2805476,15392644,2805476,0,0.954,283265690169,-0.102,-24194220,3637567367,564952852,-589147072,0.789,287881458703
881104,农业服务,-0.065,0,2095341,0,0,1.367,60672553124,-1.133,6045152,553404784,59497782,-53452630,0.721,60209490601
881105,煤炭开采加工,0.001,10675072,62336533,27504012,-16828940,1.07,1773339466130,0.035,-161625679,12367254094,3149319006,-3310944685,0.915,1767678870646
881106,石油矿业开采,-0.045,-18989010,61317975,19689899,-38678909,2.394,1885905481170,-0.058,-459554414,5179585823,1484666853,-1944221267,0.904,1869567529627
881107,油气开采及服务,-0.866,144129,67921710,23827198,-23683069,2.666,386715584337,-1.771,-486310145,5863049057,1419407105,-1905717250,0.899,383581454816
881108,化学原料,0.295,6564989,79720096,26265287,-19700298,3.133,499951363804,-0.076,-175252783,7891788131,1437379713,-1612632496,1.185,498457773105
881109,化学制品,-0.15,-12250696,225752360,54235444,-66486140,2.008,1701358947704,-0.32,-188304356,24774612857,4532658838,-4720963194,0.944,1707510902659
881110,化工合成材料,0.088,3342,73411347,15434235,-15430893,1.643,490299718212,-0.127,63758770,9298547547,1466748010,-1402989240,0.931,490516382473
881111,化工新材料,0.1,-1990649,26371644,7640395,-9631044,1.664,443244853577,-0.651,90576925,4012652949,952695251,-862118326,0.986,445919200688
881112,钢铁,-0.154,-4006385,43254796,8708846,-12715231,1.277,800577227520,0.449,-318014152,7392897490,1593303587,-1911317739,0.837,804801720389
881113,有色冶炼加工,-0.835,-12652832,381658669,130594183,-143247015,1.811,2209361103631,0.816,650819085,50001693780,15197750064,-14546930979,0.881,2257791260028
881114,金属新材料,-0.073,-962538,12283151,530577,-1493115,0.934,125129416022,0.299,7151676,2604125180,380688495,-373536819,0.852,125591854595
881115,建筑材料,0.327,9914266,88554459,42072384,-32158118,3.564,564831375618,-0.205,-183719428,9298905111,1805911279,-1989630707,1.101,565781617960
881116,建筑装饰,0.144,-134634338,569075495,196645938,-331280276,4.037,1394711038523,-0.009,-1037083331,29176835488,7656235278,-8693318609,1.139,1396583921254
881117,通用设备,0.024,803290,181298760,55862514,-55059224,2.12,593815569197,-0.557,-400115182,17789021642,2795395907,-3195511089,0.934,593794538464
881118,专用设备,-0.029,5747739,285866456,98368740,-92621001,2.569,1208530437289,-0.335,-323722379,28105814646,5532550231,-5856272610,0.987,1204234658774
881119,仪器仪表,0.151,-1406626,22539994,4823586,-6230212,2.027,117663618659,0.226,12388958,2958457459,327900779,-315511821,0.961,118130403494
881120,电力设备,-0.192,18176234,556621062,190179097,-172002863,1.779,4123249022703,-0.131,-59704615,75850205501,16531906753,-16591611368,0.988,4136917548278
881121,半导体及元件,-0.217,-10281979,439883475,179646689,-189928668,1.905,2411381393114,-0.472,-681978217,44543771520,9769219312,-10451197529,0.969,2402904460449
881122,光学光电子,0.173,-13511178,116453944,25062642,-38573820,1.978,781175855943,-0.215,-308600693,17045678906,3964211748,-4272812441,1.072,780638503044
881123,其他电子,0.586,27059197,103625486,61166510,-34107313,3.102,145151369340,0.333,-45794845,8199844750,2143449120,-2189243965,1.045,145072838280
881124,消费电子,-0.038,-8228412,189580716,59016700,-67245112,1.972,1333351430016,0.253,-145426298,25165100960,6203381043,-6348807341,1.079,1355107273629
881125,汽车整车,-0.263,-21510309,178231051,72220444,-93730753,1.545,1212857975440,0.963,2100618,23631356153,8354504803,-8352404185,1.12,1218698850622
881126,汽车零部件,0.187,-8579686,339305985,114404188,-122983874,2.559,1400721336323,0.749,-46261788,36454421448,7870799362,-7917061150,1.075,1418073035486
881127,非汽车交运,0.133,2592605,49999300,15258823,-12666218,2.031,419615116525,1.386,70008980,7316204713,1935685172,-1865676192,0.978,419165167131
881128,汽车服务,-0.87,0,4406944,0,0,1.337,61065195690,-0.778,-14921231,822801302,125483390,-140404621,0.943,61350369687
881129,通信设备,-0.262,-35103604,296686302,108391325,-143494929,3.719,829766806535,0.408,-118401446,29112396942,7940289504,-8058690950,1.132,836454876209
881130,计算机设备,0.522,-10002675,211807989,84526092,-94528767,2.169,786610522439,-0.254,-513280106,18212999138,4167327672,-4680607778,1.038,785564801048
881131,白色家电,0.274,6663065,87728919,27265303,-20602238,3.399,1081189266145,2.861,65607827,12990987313,3478588033,-3412980206,1.347,1104787985043
881132,黑色家电,0.115,3252735,24245133,9869201,-6616466,2.316,124034772841,0.902,80711206,3918363310,929112841,-848401635,1.508,125702419957
881133,饮料制造,-0.221,-15735199,135504368,78632257,-94367456,1.824,4019322426366,0.481,-235141155,14966334651,4528837146,-4763978301,1.027,4046313685411
881134,食品加工制造,-0.245,-442231,34364196,4077936,-4520167,1.198,886070033598,0.676,32868272,8958256203,1516119054,-1483250782,0.965,899559877441
881135,纺织制造,-0.46,-1606353,16787004,0,-1606353,1.992,115622550016,-0.031,-18439527,1988459435,240677852,-259117379,0.815,116635333915
881136,服装家纺,0.176,883053,28732991,3085866,-2202813,2.015,255786795380,0.029,-110149303,3599380249,383791708,-493941011,0.876,256290207250
881137,造纸,-0.181,-1978142,19090185,1908625,-3886767,2.593,148367006800,-0.965,-13475451,1973257599,303911932,-317387383,0.875,148320560474
881138,包装印刷,0.039,-1304619,131904293,67952273,-69256892,5.962,152484067729,-0.652,-336057591,5563112601,968931805,-1304989396,1.159,151975465663
881139,家用轻工,-0.183,-2703572,105813723,21817130,-24520702,3.705,512548115411,0.116,-196781835,8197776041,1019414915,-1216196750,1.003,514050924210
881140,化学制药,0.054,872950,144451019,47805155,-46932205,1.892,1357810068708,-1.167,-495199315,18376854954,3215802817,-3711002132,0.938,1333977454438
881141,中药,-0.227,-1004509,59190800,10262537,-11267046,1.51,944924599862,-0.956,-441956695,10706816199,1708607088,-2150563783,0.908,944588387640
881142,生物制品,0.136,-408716,38702600,9017062,-9425778,1.138,687084011796,0.042,-170735790,7006733959,1134018566,-1304754356,0.984,685078288405
881143,医药商业,-0.241,-71961,10525228,765582,-837543,0.872,292065463427,-0.048,-33799223,3373111497,536914448,-570713671,1.026,294587787134
881144,医疗器械,-0.012,9467500,54055479,19810524,-10343024,1.159,1101079966533,-0.464,-5658940,9529762457,1383137733,-1388796673,0.878,1100113325004
881145,电力,-0.084,-22573848,165264555,38207802,-60781650,1.715,2660653198678,-1.767,-1551603381,24082517255,5735327445,-7286930826,1.091,2627747533739
881146,燃气,-0.006,-165029,9482928,342471,-507500,1.505,190968980059,-1.343,-13466676,1773717554,215669917,-229136593,0.891,188578790601
881147,环保工程,0.245,-1319591,45458118,9192441,-10512032,1.831,357605460575,-1.809,-77907590,5752175073,803619451,-881527041,0.9,353840285843
881148,港口航运,-0.26,-1576077,38523955,10236838,-11812915,1.441,826869659932,0.193,-139288718,6540579630,1486869314,-1626158032,1.016,824695739575
881149,公路铁路运输,-0.426,-5213480,38659631,7384084,-12597564,2.17,761701188671,-1.556,-194790962,5096353902,1156721906,-1351512868,1.044,754301493584
881150,公交,-0.934,-2782000,13275094,1584135,-4366135,4.979,26602364811,-2.403,-36153673,678329281,71081744,-107235417,0.883,26315324422
881151,机场航运,0.715,-93297553,269966738,116143055,-209440608,6.739,490419595433,1.738,54757501,6202548982,2328069907,-2273312406,1.029,495729684418
881152,物流,-0.253,312604,33113905,7467442,-7154838,1.604,564882702327,-0.76,-55253903,5690374970,1041375060,-1096628963,0.973,564395012158
881153,房地产开发,-0.147,-3476359,65878896,11626169,-15102528,1.854,847601600376,-0.867,-485594946,9518339078,2274700981,-2760295927,0.897,844763441041
881154,园区开发,-0.189,1059448,7720770,2818374,-1758926,1.418,121703712780,-0.111,-20261724,970716084,155283507,-175545231,0.849,122041253135
881155,银行,-0.182,-2520179,215087336,105879212,-108399391,2.763,7737625942396,1.095,43363382,31773848488,13956603786,-13913240404,1.487,7834858963428
881156,保险及其他,-0.226,-4621799,44065565,9604570,-14226369,1.611,1839170956186,0.223,214761554,12492130913,3958483453,-3743721899,1.256,1883345506720
881157,证券,-0.426,687296,122136127,43369056,-42681760,1.446,2222815837987,0.939,440053216,25591515718,8316489539,-7876436323,1.29,2250112197906
881158,零售,0.096,7948574,56778830,14677846,-6729272,1.864,559292367889,-0.96,-214185710,7108274693,1404095347,-1618281057,0.806,557084679765
881159,贸易,-0.352,2285815,20389624,3995620,-1709805,1.595,82700494084,-0.452,45394470,2762153796,519316009,-473921539,1.022,83034099721
881160,景点及旅游,-0.523,-3171765,43671599,4948056,-8119821,1.602,110510152592,1.492,-51719859,5862957425,1081733827,-1133453686,0.819,113021123858
881161,酒店及餐饮,-1.131,-853890,9793166,1315004,-2168894,0.745,67411178483,-0.168,-80052833,1949371777,287818820,-367871653,0.635,67937111404
881162,通信服务,-0.446,-7886680,83206495,18281227,-26167907,2.233,521402284956,-0.924,-340542768,9982543368,2386221593,-2726764361,1.078,521006377977
881163,计算机应用,0.005,-11944475,286497172,66972853,-78917328,1.58,1769660586637,-0.667,-299994123,42662700809,8355927872,-8655921995,0.941,1764172249625
881164,传媒,-0.291,-10441032,220389883,49140645,-59581677,1.831,1169802092973,-0.985,-681081811,30731424478,5997503185,-6678584996,0.916,1163854728676
881165,综合,-0.545,-349805,16465866,2267832,-2617637,1.671,200514196869,-1.55,-143691980,2120253209,310000260,-453692240,0.774,199575289512
881166,国防军工,0.139,-22904374,207755981,53961992,-76866366,2.076,1674632428084,1.188,2125003,31393126714,7139293337,-7137168334,1.164,1688162808627
881167,非金属材料,-0.355,-2270178,8534369,433160,-2703338,0.963,79073551196,0.343,-62669557,1811523207,348081557,-410751114,0.857,79089526771
881168,工业金属,-0.587,-4931169,202099286,69643802,-74574971,1.646,1213572709422,0.457,172846223,27074130062,8761939556,-8589093333,0.866,1241014878716
881169,贵金属,-2.536,-3986541,95602332,38010657,-41997198,2.89,312244649248,1.711,-252389855,9035644926,2289032183,-2541422038,0.877,317524104400
881170,小金属,-0.27,-9229366,153558347,44103416,-53332782,1.756,817131277971,1.972,956659694,20694336128,6099186978,-5142527284,0.973,836766354374
881171,自动化设备,-0.234,-14215275,98867252,23380442,-37595717,2.1,587093656805,-0.113,-126221217,12704710836,2594902986,-2721124203,1.105,589055381731
881172,电子化学品,-0.147,-1036262,19454438,2008371,-3044633,1.471,176109794881,-0.594,-117762770,3705660552,503379264,-621142034,0.991,176225378556
881173,小家电,-0.672,1208480,33844227,7894381,-6685901,2.818,213077237876,1.504,172465847,4459271811,996552054,-824086207,1.485,217405558023
881174,厨卫电器,-1.957,5806293,28982404,11260223,-5453930,3.957,60112052107,0.319,8534644,2208395519,372559786,-364025142,1.491,61447314280
881175,医疗服务,-0.097,-13120046,100953124,33846683,-46966729,2.182,526862461204,-0.322,-13120214,11286809811,2898226672,-2911346886,1.024,526881686778
881176,房地产服务,0.212,0,2881713,0,0,1.611,28187235883,-1.113,15157783,463025777,53300176,-38142393,0.868,27943692132
881177,互联网电商,-0.135,813868,10706994,2207398,-1393530,1.427,78615207623,-0.245,11295905,1736781445,237401933,-226106028,0.826,78210175688
881178,教育,0.048,-2710759,20949744,4169227,-6879986,2.805,64208321024,-0.84,-10801471,1918653342,285806322,-296607793,1.061,64115946369
881179,其他社会服务,0.199,3172136,40282384,14792070,-11619934,3.803,117880410075,0.756,102352805,4467097629,866297065,-763944260,1.145,119460873036
881180,石油加工贸易,-0.409,-25311056,76121296,23479711,-48790767,2.796,2703908496405,-0.942,-536332659,6383563023,1766908366,-2303241025,1.0,2687051171238
881181,环保,0.156,-16870198,104535252,17702588,-34572786,2.293,583699738855,-1.387,-240880503,10422655829,1471387040,-1712267543,0.95,579126297663
881182,美容护理,-0.442,907883,10924567,1243200,-335317,1.18,226367443796,-0.505,-39895746,2613626736,417847471,-457743217,0.905,227587872188
